::'######:::'#######::'########::'########:::::'######::'##::::::::::'###::::'##:::'##:'########:'########::
:'##... ##:'##.... ##: ##.... ##: ##.....:::::'##... ##: ##:::::::::'## ##:::. ##:'##:: ##.....:: ##.... ##:
: ##:::..:: ##:::: ##: ##:::: ##: ##:::::::::: ##:::..:: ##::::::::'##:. ##:::. ####::: ##::::::: ##:::: ##:
: ##::::::: ##:::: ##: ##:::: ##: ######::::::. ######:: ##:::::::'##:::. ##:::. ##:::: ######::: ########::
: ##::::::: ##:::: ##: ##:::: ##: ##...::::::::..... ##: ##::::::: #########:::: ##:::: ##...:::: ##.. ##:::
: ##::: ##: ##:::: ##: ##:::: ##: ##::::::::::'##::: ##: ##::::::: ##.... ##:::: ##:::: ##::::::: ##::. ##::
:. ######::. #######:: ########:: ########::::. ######:: ########: ##:::: ##:::: ##:::: ########: ##:::. ##:
::......::::.......:::........:::........::::::......:::........::..:::::..:::::..:::::........::..:::::..::