         * Old *     *     *     * New *
*--------|-----|-----|-----|-----|-----||
   Word  |     |     |     |     |     ||
*--------|-----|-----|-----|-----|-----||
  Short  |     |     |     |     |     ||
*--------|-----|-----|-----|-----|-----||
   Long  |     |     |     |     |     ||
*--------|-----|-----|-----|-----|-----||
 