   +---------------+
   |               |
   |               |
   |               |
(T o T)            |
--||--             |
 /                 |
                   |
                   |
                   |
           ===========