   +---------------+
   |               |
   |               |
   |               |
( ^¿À^)            |
--||--             |
 / |               |
                   |
                   |
                   |
           ===========